5 13 31
###############################
#p * *6       *  ** * *      *#
# # # # #*# # #*# # # # # #*# #
#    * * **s **  5   *    **  #
# #*# # # # # # #b#1# # # # #*#
#         8*     **      *  **#
# # #*# # # # # #*#*#*#*# # # #
#   *        *   * *x* *   4  #
# # # # #*# # # # # # #*# #*# #
#   ****         *7           #
# # # # # # # # # #*# # # # #*#
#  ** *5  *    3          9   #
###############################