3 13 31
###############################
#p   ** **    *   2           #
# # # #*# # # # # # # # # # # #
#*     ** * s  *   * ** 3 *   #
# # # # # #*# # # # # # #*# # #
#*   f**    *** * * **        #
# # # # # # # # # # # # # #*# #
#    *     *        *    **  3#
# #*# # #*#*#*#*# # #1# # #*# #
#        *   *2*    *   *     #
#*# # # # # # # # # # #*# # #x#
# *    * **    ** ***     1   #
###############################