1 13 31
###############################
#p     ?d *  j * k *  * * *   #
# # # #*# # #*#*# # # #*#*#*# #
#  x*     bs*  *  l   * 2 * b #
# # # # # #*# # #*#*# # # # #*#
#f         x **  *  *   1     #
# # # # # # # # # #*# #*# # # #
#*  *      *  *          8    #
# # # # #*# # # #*#*# # # # # #
#*    **  *5      *      9    #
# #*# # # # # # #*# # # # # # #
#         7 *   *  *     9    #
###############################



Items:
b - Bomb Item
f - Flame Item
s - Speed Item
d - Detonator Item
j - Wallpass Item
k - Bombpass Item
l - Flamepass Item
? - Mystery Item