3 13 31
###############################
#p   ** **    *   5           #
# # # #*# # # # # # # # # # # #
#*     ** * s  *   * ** 3 *   #
# # # # # #*# # # # # # #*# # #
#*   f**    *** * * **        #
# # # # # # # # # # # # # #*# #
#   6*     *        *    **  3#
# #*# # #*#*#*#*# # #1# # #*# #
#        *   *2*    *   *     #
#*# # # # # # # # # # #*# # #x#
# *    * **    ** ***     1   #
###############################