2 13 31
###############################
#p * *2       *  ** * b  4   *#
# # # # #*# # #*# # # # # #*# #
#    * * *** **      *    **  #
# #*# # # # #3# #*#1# # # # #*#
#          *     *b      *  **#
# # #*# # # # # #*#*#*#*# # # #
#   *        *   * *x* *      #
# # # # #*# # # # # # #*# #*# #
#   **s*         *1           #
# # # # # # # # # #*# # # # #*#
#  *f *   *    2              #
###############################
